1111111111111111111111111111111111
1E001000100000000000000011110000C1
1000100010000000000000000001000001
1000100010000000000000000001000001
1000111110000000000000001111000001
1000000010000000000000001000000001
1000000000000000000000000000000001
10000000100000000000000011110000P1
1111111111111111111111111111111111
