11111111111111111111111111111111111111111111111111111111111
10000000000C00000000000000000000000P00000000000000000000001
10000111111100000000011111000000000000000000000000001011001
10000111111100000000011111111100000000000C0000011111C011001
10000111111111000000000000000000000000000000000111111111001
100000000000000000001111111111111100000000E0000000000000001
11111111111111111111111111111111111111111111111111111111111
