1111111111111
100C000000001
10E000000 001
100000000P001
1111111111111
