000000000000000
1111111E0000001
1000000000000C0
011111111111110
000000000000000