1111111111111111111111111
100C000000E000000P0000001
1000000000000000000000001
1111111111111111111111111
