11111111111111111111111
1E00C00000C000000100001
100001010010CCC00010101
11010001001001000010101
1C00P000000000000000C11
11111111111111111111111
