111111111111
100C000000E1
100000000001
111111111111
