1111111111111111111111111
100C000000E00000000000001
1000000P00000000000000001
1111111111111111111111111
