1111111111
1000000E01
1000000001
10C0000001
1000000001
1000C00001
1000000001
1000000001
1P000000C1
1111111111